（痛みや嫌悪、不快感で）眉をひそめる→grimace
（独善的な）にやにや 片方の口角が上がっている→smirk
（不意にロマンチックな状況になって）慌てる顔→flustered
V字眉（ ＼ ／ こういう眉）→v-shaped eyebrows
アヘ顔→ahegao
イライラ→annoyed
うつ→depressed
キューブリックの凝視→kubrick stare
ショックや絶望などでモノクロになること→color drain
シリアス、深刻な表情→serious
すすり泣く→sobbing
ため息→sigh
ドヤ顔→doyagao, self-satisfaction, smugness
ナーバス、緊張→nervous
にやにや→grin
パニック、慌てる→panicking
ふくれっ面→pout
レイプ顔→rape face
レイプ目→empty eyes
押し殺した笑い、笑いをこらえる→stifled laugh
顔に手を置く。やれやれ顔→facepalm
顔に置く→hand_on_own_face
顔全体の赤面→full-face blush
泣く→crying
泣く（目を開いて）→crying with eyes open
強制的な笑顔（作り笑い？）→forced smile
恐ろしい→horrified
恐怖、痛み、苦痛で眉をひそめる、ひるむ→wince
驚いた顔→surprised
軽い笑顔（モナリザのような）ほほえみ→light smile
軽蔑→disdain
決心した表情、決め顔→determined
嫌悪→disgust
口を開ける→open mouth
口角が切り裂かれた笑顔→glasgow smile
幸せな表情→happy
考える顔→thinking
混乱した表情→confused
罪悪感→guilt
指で口角を上げる笑顔→fingersmile
歯を食いしばる→clenched teeth
失望した、呆れ顔→disappointed
邪悪なにやにや→evil grin
邪悪な笑顔→evil smile
邪悪な表情、悪だくみ→evil
寂しい、孤独→lonely
笑顔→smile
上向きの目（アヘ顔）→rolling eyes
心配する→worried
震える→trembling
酔っ払い、お酒に酔った顔→drunk
青ざめる→turn pale
絶叫　叫ぶ→screaming
絶頂→orgasm
絶望→despair
楕円形の頬→blush stickers
退屈そうな表情→bored
恥ずかしい→embarrassed
痛みの表情→pain
妬みの表情、嫉妬→envy
怒り→angry
怒りマーク💢、青筋→anger vein
動揺する→upset
独善的 前で腕を組むようなドヤ顔　お嬢様のような…→smug
波状の口→wavy mouth
悲しい→sad
悲しみで眉をひそめる→frown
悲しみの笑顔→sad smile
疲れた表情→tired
眉間にしわ→furrowed brow
鼻の上を赤らめる→nose blush
鼻血を流す→nosebleed
病んだ笑顔→crazy smile
病んでいる表情→crazy
不満な表情 欲求不満→frustrated
怖がる→scared
物思いに耽る→pensive
片眉を上げた表情→raised eyebrow
片目を閉じる（ウインク）→one eye closed (winking)
頬に当てる→hand_on_own_cheek
頬染め→blush
漫画的なびっくり表現→^^^
魅惑的な笑顔→seductive smile
眠い表情→sleepy
無表情、真顔→expressionless
目を閉じた顔→closed eyes
憂鬱な表情→gloom (expression)
離れた唇→parted lips
涙をながす→tears
涙目→water eye
嘲る顔？　嘲笑？→troll face
拗ねた顔→sulking
羞恥A→shy